XXXXXXXXXXXXXXXXXXXX
XA-----------------X
X-XXXXXXXX-XXX-XXXXX
X-XXXXX-XXXXXX-XXXXX
X------------------X
X-XXX-XX-XXXXXXX-XXX
X------------------X
X-XXXXXX-XXXXX-XXXXX
X-X----------------X
X-XXX-XXXXXX-XXXXXXX
X-X----------------X
X-XXXXXX-XXXXXX-XXXX
X-X----------------X
X-XXXXXXXXX-XXXXXXXX
X-X----------------X
X-XXXXX-XXX-XXXXXXXX
X-X----------------X
XXXXXXXXXXXXXXXXXX-X
XX-----------------X
XXXBXXXXXXXXXXXXXXXX